WWWWWWWWWWWWWWWWWWWWWWWWWWWWWWWWWWW
W B B W B W B B W B B W B B W B B W
W W W W W W W W W W W W W W W W W W
W B B W B W B B W B B W B B W B B W
W W W W W W W W W W W W W W W W W W
W B B W B W B B W B B W B B W B B W
W W W W W W W W W W W W W W W W W W
W B B W B W B B W B B W B B W B B W
W W W W W W W W W W W W W W W W W W
W B B W B W B B W B B W B B W B B W
WWWWWWWWWWWWWWWWWWWWWWWWWWWWWWWWWWW
